
#                            #  #
#                            #  #
#                            #  #
#                            #  #
#         *                  #  #
#                            #  #
#     *  ##                  #  #
#        *     #             #  #
#     #    #                 #  #
#   ##       #               #  #
########O######O#################